1111111111111111111
1001000000000000J11
10000P0000000000011
10C00111111111000E1
1000000000000000001
1000000111111100001
1000000000000100001
1000000000000100001
1111111111111111111