1111111111111111111
1001011111111110011
10000P1111100111111
10C00111111111000E1
1111111111111111111