1111111111111111111
1001000000010000011
1000000000010000011
10C00111111111000E1
1000000001010000001
1000000111111100001
10CCC0000001010J001
100000P0000C0000001
1111111111111111111