1111111111111111111
1001000000000000J11
10000P0000000000011
10C00111111111000E1
1111111111111111111
