111111111111111111111111111111111111111111
100000001C10000000000000000000000000000001
111000111011110000000000000000000000000001
11001110001100000000000000000000000J000001
111000000000111111100000000000000000000001
100000000000000000000000000000000000000001
100000000000000000000000000000000000000001
100000000000000000000000000000000000000001
100000000000000000000000000000000000000001
100000000000000000000000000000000000000001
100000000000000000000000000000000000000001
100000000000000000000000000000000000000001
100000000000000000001111110000000000000001
10000000000000000000000P010000000000000001
100000000000000000001111010000000000000001
100000000000000000000001C10000000000000001
100000000000000000000001111111111111000001
100000000000000000000000000011111111111001
100000000000000000000000000011111111111111
1000000000000000000000000000000000000000E1
111111111111111111111111111111111111111111
