1111111111
1001010011
10000P0011
10C00000E1
1111111111